111111111111111
100000101000001
100000000001111
1111000N0000001
100001001000011
111111111111111
