1111111111111111111111111
1000000000110000000000001
1010000001110000010000001
1001000000000000000001001
1000000000N00000000000001
1111111111111111111111111
