NO ./scenes/textures/flag_nazi.xpm42
SO ./scenes/textures/flag_soviet.xpm42
WE ./scenes/textures/flag_ss.xpm42
EA ./scenes/textures/flag_usa.xpm42

F 124,96,124
C 0,32,32

111111111111111111111111111111111111111111111111
100000000000000000000000000000000000000000000001
100111111111110000011111111111000000111111110001
100100000000000000000000000000000000100000010001
100100011111000111100000011111111111100111010001
100100010001000100000111000000000000100001010001
100000010001000100000000000000000000100001010001
111111110001000111111000111111111000100001010001
100000000001000000001000100000001000000001010001
100111111111111100001111100011111100111111111001
100100000000000100000000000000000000100000000001
100100000111111111111111110001111111100000111001
100100000000000000000000000000000000000000001001
100111111111111111111111111111111100000000001001
100100000000000000000000000000001100011111111001
100100000000111111111111000011001100000000000001
100111111000100000000001000000001111100000000001
100000001000100000000001111111000000000011111111
111110001000100000000000000000000111111111000001
100000000000100000000111111111111000000000000001
100000000000100N00000100000000000000000000000001
100011111111111111111111000000011111111100111111
100000000000000000000000000000000000000000100001
111111111111111111111111111111111111111111111111